1,1,1,1,1,1,1,1,1
1,5,6,7,2,2,2,2,1
1,0,0,0,0,0,0,0,1
1,0,0,0,0,0,0,0,1
1,0,0,0,0,0,0,0,1
1,0,0,0,0,0,0,0,1
1,0,0,0,0,0,0,0,1
1,0,0,0,4,0,0,0,1
1,0,0,0,0,0,0,0,1
1,1,1,1,1,1,1,1,1